17 15
10 10 10 10 10 3 0 0 0 0 0 0 3 10 10 10 10 
10 10 10 10 10 3 1 1 1 1 1 1 3 10 10 10 10 
8 8 8 8 8 3 1 1 1 1 1 1 3 8 8 8 8 
8 8 8 8 8 3 0 0 0 0 0 0 3 9 8 9 8 
3 3 3 3 3 3 0 0 0 0 0 0 3 3 3 3 3 
0 2 2 0 0 0 0 0 0 0 0 0 0 0 2 2 0 
0 2 2 0 0 0 0 0 0 0 0 0 0 0 2 2 0 
0 2 2 0 0 0 0 0 0 0 0 0 0 0 2 2 0 
0 2 2 0 0 0 0 0 0 0 0 0 0 0 2 2 0 
0 2 2 0 0 0 0 0 0 0 0 0 0 0 2 2 0 
3 3 3 3 3 3 0 0 0 0 0 0 3 3 3 3 3 
10 10 10 10 10 3 0 0 0 0 0 0 3 10 10 10 10 
10 10 10 10 10 3 0 0 0 0 0 0 3 10 10 10 10 
10 10 10 10 10 3 0 0 0 0 0 0 3 10 10 10 10 
10 10 10 10 10 3 0 0 0 0 0 0 3 10 10 10 10 
0
