53 31
10 10 10 10 10 3 0 0 0 0 0 0 3 10 10 10 10 10 10 10 10 10 10 10 3 3 0 0 0 0 0 0 3 3 10 10 10 10 10 10 10 10 10 10 3 3 0 0 0 0 0 3 3 
10 10 10 10 10 3 0 0 0 0 0 0 3 10 10 10 10 10 10 10 10 10 10 10 3 3 0 0 0 0 0 0 3 3 8 8 8 8 8 8 8 8 8 8 3 3 0 0 0 0 0 3 3 
8 8 8 8 8 3 0 0 0 0 0 0 3 8 8 8 8 8 8 8 8 8 8 8 3 3 0 0 0 0 0 0 3 3 8 8 8 8 8 8 8 8 8 8 3 3 0 0 0 0 0 3 3 
8 8 8 8 8 3 0 0 0 0 0 0 3 9 8 9 8 8 8 8 8 9 8 8 3 3 0 0 0 0 0 0 3 3 3 3 3 3 3 3 3 3 3 3 3 3 0 0 0 0 0 3 3 
3 3 3 3 3 3 0 0 0 0 0 0 3 3 3 3 3 3 3 3 3 3 3 3 3 3 0 0 0 0 0 0 3 3 3 3 3 3 3 3 3 3 3 3 3 3 0 0 0 0 0 3 3 
0 2 2 0 0 0 0 0 0 0 0 0 0 0 2 2 0 0 0 0 0 0 0 0 0 0 0 0 0 0 0 0 0 0 0 0 0 2 2 0 0 0 0 0 0 0 0 0 0 0 0 0 0 
0 2 2 0 0 0 0 0 0 0 0 0 0 0 2 2 0 0 0 0 0 0 0 0 0 0 0 0 0 0 0 0 0 0 0 0 0 2 2 0 0 0 0 0 0 0 0 0 0 0 0 0 0 
0 2 2 0 0 0 0 0 0 0 0 0 0 0 2 2 0 0 0 0 0 0 0 0 0 0 0 0 0 0 0 0 0 0 0 0 0 2 2 0 0 0 0 0 0 0 0 0 0 0 0 0 0 
0 2 2 0 0 0 0 0 0 0 0 0 0 0 2 2 0 0 0 0 0 0 0 0 0 0 0 0 0 0 0 0 0 0 0 0 0 2 2 0 0 0 0 0 0 0 0 0 0 0 0 0 0 
0 2 2 0 0 0 0 0 0 0 0 0 0 0 2 2 0 0 0 0 0 0 0 0 0 0 0 0 0 0 0 0 0 0 0 0 0 2 2 0 0 0 0 0 0 0 0 0 0 0 0 0 0 
3 3 3 3 3 3 0 0 0 0 0 0 3 3 3 3 3 3 3 3 3 3 3 3 3 3 0 0 0 0 0 0 3 3 3 3 3 3 3 3 3 3 3 3 3 3 3 3 3 3 3 3 3 
10 10 10 10 10 3 0 0 0 0 0 0 3 10 10 10 10 10 10 10 10 10 10 10 10 3 0 0 0 0 0 0 3 3 3 3 3 3 3 3 3 3 3 3 3 3 3 3 3 3 3 3 3 
10 10 10 10 10 3 1 1 1 1 1 1 3 10 10 10 10 10 10 10 10 10 10 10 10 3 0 0 0 0 0 0 3 3 10 10 10 10 10 10 10 10 10 10 10 10 10 10 10 10 10 10 10 
10 10 10 10 10 3 1 1 1 1 1 1 3 10 10 10 10 10 10 10 10 10 10 10 10 3 0 0 0 0 0 0 3 3 10 10 10 10 10 10 10 10 10 10 10 10 10 10 10 10 10 10 10 
10 10 10 10 10 3 0 0 0 0 0 0 3 10 10 10 10 10 10 10 10 10 10 10 10 3 0 0 0 0 0 0 3 3 10 10 10 10 10 10 10 10 10 10 10 10 10 10 10 10 10 10 10 
10 10 10 10 10 3 0 0 0 0 0 0 3 10 10 10 10 10 10 10 10 10 10 10 10 3 0 0 0 0 0 0 3 3 10 10 10 10 10 10 10 10 10 10 10 10 10 10 10 10 10 10 10 
10 10 10 10 10 3 0 0 0 0 0 0 3 10 10 10 10 10 10 10 10 10 10 10 10 3 0 0 0 0 0 0 3 3 10 10 10 10 10 10 10 10 10 10 10 10 10 10 10 10 10 10 10 
8 9 8 9 8 3 0 0 0 0 0 0 3 10 10 10 10 10 10 10 10 10 10 10 10 3 0 0 0 0 0 0 3 3 10 10 10 10 10 10 10 10 10 10 10 10 10 10 10 10 10 10 10 
8 8 8 8 8 3 0 0 0 0 0 0 3 8 9 8 8 9 8 8 9 8 8 9 8 3 1 1 1 1 1 1 3 3 8 8 8 8 8 8 8 8 8 8 8 8 8 8 8 8 8 8 8 
8 8 8 8 8 3 0 0 0 0 0 0 3 8 8 8 8 8 8 8 8 8 8 8 8 3 1 1 1 1 1 1 3 3 8 8 8 8 8 8 8 8 8 8 8 8 8 8 8 8 8 8 8 
3 3 3 3 3 3 0 0 0 0 0 0 3 8 9 8 8 9 8 8 9 8 8 9 8 3 0 0 0 0 0 0 3 3 3 3 3 3 3 3 3 3 3 3 3 3 3 3 3 3 3 3 3 
3 3 3 3 3 3 0 0 0 0 0 0 3 3 3 3 3 3 3 3 3 3 3 3 3 3 0 0 0 0 0 0 3 3 3 3 3 3 3 3 3 3 3 3 3 3 3 3 3 3 3 3 3 
0 2 2 0 0 0 0 0 0 0 0 0 0 0 0 0 0 0 2 2 0 0 0 0 0 0 0 0 0 0 0 0 0 0 0 0 0 0 0 0 0 0 0 0 0 0 0 0 0 0 0 0 0 
0 2 2 0 0 0 0 0 0 0 0 0 0 0 0 0 0 0 2 2 0 0 0 0 0 0 0 0 0 0 0 0 0 0 0 0 0 0 0 0 0 0 0 0 0 0 0 0 0 0 0 0 0 
0 2 2 0 0 0 0 0 0 0 0 0 0 0 0 0 0 0 2 2 0 0 0 0 0 0 0 0 0 0 0 0 0 0 0 0 0 0 0 0 0 0 0 0 0 0 0 0 0 0 0 0 0 
0 2 2 0 0 0 0 0 0 0 0 0 0 0 0 0 0 0 2 2 0 0 0 0 0 0 0 0 0 0 0 0 0 0 0 0 0 0 0 0 0 0 0 0 0 0 0 0 0 0 0 0 0 
3 3 3 3 3 3 0 0 0 0 0 0 3 3 3 3 3 3 3 3 3 3 3 3 3 3 3 3 3 3 3 3 3 3 3 3 3 3 3 3 0 0 0 0 0 0 3 3 3 3 3 3 3 
3 3 3 3 3 3 0 0 0 0 0 0 3 3 3 3 3 3 3 3 3 3 3 3 3 3 3 3 3 3 3 3 3 3 3 3 3 3 3 3 0 0 0 0 0 0 3 10 10 10 10 10 10 
10 10 10 10 3 3 0 0 0 0 0 0 3 10 10 10 10 10 10 10 10 10 10 10 10 10 10 10 10 10 10 10 10 10 10 10 10 10 3 3 0 0 0 0 0 0 3 10 10 10 10 10 10 
10 10 10 10 3 3 0 0 0 0 0 0 3 10 10 10 10 10 10 10 10 10 10 10 10 10 10 10 10 10 10 10 10 10 10 10 10 10 3 3 0 0 0 0 0 0 3 10 10 10 10 10 10 
10 10 10 10 3 3 0 0 0 0 0 0 3 10 10 10 10 10 10 10 10 10 10 10 10 10 10 10 10 10 10 10 10 10 10 10 10 10 3 3 0 0 0 0 0 0 3 10 10 10 10 10 10 
4
8 7
8 24
28 24
28 7
